k	k
kh	kʰ
ng	ŋ
ch	tɕ
s	s
y	j
d	d
t	t
th	tʰ
n	n
d	d
b	b
p	p	
ph	pʰ
f	f
m	m
r	r	
rue	rue
ri	ri
roe	roe
l	l
lue	lue
w	w
h	h
a	a
an	an
am	am
i	i
ue	ɯ
u	u
e	e
ae	ɛ
o	ɔ o
oe	ɤ
ia	ia
uea	ɯa
ua	ua
ai	aj
ao	aw
ui	uj
oi	ɔj
oei	ɤj
ueai	ɯaj
uai	uaj
io	iw
eo	ew
aeo	ɛw
iao	iaw
