13.	sānshí diǎn	half-witted
13点	sānshí diǎn	half-witted
㒲	cái	bribes
龫	gàn	to fuck
㞗	qiú	penis
丄	shàng	to screw
三小	sānxiǎo	what the hell? [Taiwan]
三级片	sānjí piàn	third category movie (containing sexual content)
上	shàng	to screw
下三烂	xià sān làn	scum
下贱	xiàjiàn	humble
个老子的	gè lǎozǐ de	that Laozis
九游	jiǔ yóu	hour nine
乳	rǔ	breast
乳交	rǔjiāo	mammary intercourse
乳头	rǔtóu	nipple
乳房	rǔfáng	breast
乳波臀浪	rǔ bō tún làng	well-rounded breasts and hips
二b	èrbī	idiot
二屄	èrbī	idiot
二逼	èrbī	idiot	
交配	jiāopèi	mating
仆街	pū jiē	to fall prostrate street
他奶奶	tā nǎinai	his grandmother
他奶奶的	tā nǎinai de	his grandmother's
他奶娘的	tā nǎiniáng de	he sees breast
他妈	tāmā	darned
他妈地	tāmā de	darned
他妈ㄉ王八蛋	tā mā wángbā dàn	darned bastard
他妈的	tāmā de	fuck!
他娘	tā niáng	his mother
他媽	tāmā	damn it!
他媽的	tāmā de	fuck!
他马的	tāmǎ de	fucking
你个傻比	nǐ gè shǎ bǐ	you idiot!
你他马的	nǐ tā mǎ de	your fucking
你全家	nǐ quánjiā	your whole family
你奶奶的	nǐ nǎinai de	your grandmother's	
你她马的	nǐ tā mǎ de	your fucking
你妈	nǐ mā	your mother
你妈的	nǐ mā de	your mother's
你娘	nǐ niáng	your mother
你娘卡好	nǐ niáng kǎ hǎo	your mother stops good
你娘咧	nǐ niáng liē	your mother's face
你娘的	nǐ niángde	your mother's
你它妈的	nǐ tā mā de	your fucking
你它马的	nǐ tā mǎ de	your fucking
你是鸡	nǐ shì jī	you are prostitute
你是鸭	nǐ shì yā	you are a male prostitute
你老母	nǐ lǎomǔ	your mother
你马的	nǐ mǎ de	your mother's ["horse"]
使恁娘	sáilínnia	fuck your mother [Min Nan]
依奶	yǐnā	fuck! [Min Dong]
做爱	zuò'ài	to make love	
傻屄	shǎbī	stupid cunt
傻屌	shǎdiǎo	foolish penis
傻比	shǎbǐ	stupid cunt
傻逼	shǎbī	stupid cunt
傻閪	shǎhāi	stupid cunt
册那	cè nà	book that
军妓	jūnjì	military prostitute
几八	jǐbā	dick
几叭	jǐbā	dick
几巴	jǐbā	dick
几芭	jǐbā	dick
刚度	gāngdù	erection
刚瘪三	gāng biēsān	hard wretched-looking tramp (?)
包皮	bāopí	foreskin
十三点	shísān diǎn	half-witted
卖b	màibī	to sell one's vagina
卖比	màibǐ	to sell one's vagina
卖淫	màiyín	prostitution
卵	luǎn	testicles
卵子	luǎnzi	testicles
双峰微颤	shuāng fēng wēi chàn	to shake tiny boobies
口交	kǒujiāo	oral sex
口爆	kǒubào	to ejaculate inside somebody's mouth
口肯	kǒu kěn	willing mouth
叫床	jiàochuáng	to cry out in ecstasy
吃屎	chī shǐ	to eat shit
后庭	hòu tíng	anus
吹箫	chuīxiāo	blowjob
哭爸	kào běi	fuck!	
啥潲	shá shào	to sprinkle something
嗝屁	gé pì	belch fart
嘐潲	xiāo shào	bombastic sprinkle
囸	rì	to fuck
塞你公	sāi nǐ gōng	plug your husband
塞你娘	sāi nǐ niáng	plug your mother
塞你母	sāi nǐ mǔ	plug your mother
塞你爸	sāi nǐ bà	plug your dad
塞你老师	sāi nǐ lǎoshī	plug your teacher
塞你老母	sāi nǐ lǎomǔ	plug your mother
处女	chǔnǚ	virgin	
外阴	wàiyīn	vulva
大卵子	dà luǎnzǐ	big ovum
大卵泡	dà luǎnpào	big follicle
大鸡巴	dà jība	big dick
奶	nǎi	breast
奶奶的熊	nǎinai de xióng	damn it! [= grandmother's bear]
奶子	nǎizi	breast
奸	jiān	rape	
奸你	jiān nǐ	(I'll) rape you
她妈地	tāmā de	fucking
她妈的	tāmā de	fucking
她马的	tāmǎ de	fucking
妈b	mā bī	damn it! [= mother's cunt]
妈个b	mā gè bī	damn it! [= mother's cunt]
妈个比	mā gè bǐ	damn it! [= mother's cunt]
妈个老比	mā gè lǎo bǐ	damn it! [= mother's old cunt]
妈妈的	māmāde	fucking
妈比	mā bǐ	damn it! [= mother's cunt]
妈的b	māde bī	damn it! [= mother's cunt]
妈的	māde	fuck!
妈蛋	mā dàn	damn it! [= mother's egg]
妈逼	mā bī	damn it! [= mother's cunt]
妓	jì	prostitute
妓女	jìnǚ	prostitute
妓院	jìyuàn	whorehouse
妳她妈的	nǐ tāmā de	your fucking
妳妈的	nǐ mā de	your fucking
妳娘的	nǐ niáng de	your fucking
妳老母的	nǐ lǎomǔ de	your fucking [= your old mother's]
妳马的	nǐ mǎ de	your fucking [= your horse's, sounds like mother's]
姘头	pīntou	lover
姣西	jiāo xī	pretty west
姦	jiān	rape
娘个比	niáng gè bǐ	damn it! [= mother's cunt]
娘的	niángde	fuck!
婊子	biǎozi	whore
婊子养的	biǎozi yǎng de	son of a bitch ["raised by a bitch"]
媽的	māde	fuck!
媽蛋	mā dàn	damn it! [= mother's egg]
嫖娼	piáochāng	to go whoring
嫖客	piáokè	patron of a brothel
孫子	sūnzi	grandson
它妈地	tāmā de	fucking
它妈的	tāmā de	fucking
宩	shǐ	shit
密洞	mì dòng	secret hole
射你	shè nǐ	(I'll) shoot you
射精	shèjīng	ejaculation
小乳头	xiǎo rǔtóu	small nipples
小卵子	xiǎo luǎnzǐ	small ovum 
小卵泡	xiǎo luǎnpào	small follicle
小瘪三	xiǎo biē sān	small wretched-looking tramp
小肉粒	xiǎo ròu lì	small balls
小骚比	xiǎo sāobī	little bitch
小骚货	xiǎo sāohuò	little slut
小鸡巴	xiǎo jība	small penis	
小鸡鸡	xiǎo jījī	small penis
屁	pì	fart
屁事	pìshì	fart matter [= trifling matter]
屁眼	pìyǎn	anus
屁股	pìgu	butt
屁股眼	pìgu yǎn	anus
屁話	pìhuà	shit
屁话	pìhuà	shit
屄	bī	cunt
屄格	bīgé	cunt
屄養	bīyǎng	horrible person
屌	diǎo	penis
屌你	diǎo nǐ	penis (to) you
屌你老母	diǎo nǐ lǎomǔ	penis (to) your old mother		
屌絲	diǎosī	loser ["penis speck"]
屎	shǐ	shit
屎忽	shǐ hū	ass [Cantonese]
屎窟	shǐ kū	asshole
屎胐	shǐ fěi	shit
屎胐鬼	shǐ fěi guǐ	shit demon
巨乳	jùrǔ	huge breasts
巴子	bāzi	vulva
干	gàn	to fuck
干x娘	gàn niáng	to fuck (your) mother
干七八	gàn qībā	fuck the cunt
干么	gànma	are you fucking?
干你	gàn nǐ	fuck you!
干你妈	gàn nǐ mā	fuck your mother
干你娘	gàn nǐ niáng	fuck your grandmother
干你老母	gàn nǐ lǎomǔ	fuck your old mother
干你良	gàn nǐ liáng	fuck you good
干吗	gànma	are you fucking?
干嘛	gànma	are you fucking?
干妳妈	gàn nǐ mā	fuck your mother
干妳娘	gàn nǐ niáng	fuck your mother
干妳老母	gàn nǎi lǎomǔ	fuck your old mother
干妳马	gàn nǐ mǎ	fuck your mother ("horse")	
干您娘	gàn nín niáng	fuck your mother
干掉	gàndiào	to completely defeat [= fuck (with) the penis]
干机掰	gàn jībāi	fuck the cunt
干死	gànsǐ	fucking 
干死你	gànsǐ nǐ	fuck you!
干死客服	gànsǐ kèfù	shitty customer service
幹	gàn	to fuck
幹你娘	gàn nǐ niáng	fuck your mother
幹嗎	gànma	are you fucking?
幹嘛	gànma	are you fucking?
幹掉	gàndiào	to completely defeat [= fuck (with) the penis]
幹麼	gànma	are you fucking?
廢文	fèi wén	to abandon culture
强奸	qiángjiān	to rape
强奸你	qiángjiān nǐ	(I'll) rape you
性	xìng	sex
性交	xìngjiāo	sexual intercourse
性器	xìngqì	sex organ
性无能	xìng wúnéng impotence
性爱	xìng'ài	sex
恁老母	lín lāobú	fuck your old mother [Min Nan]
情色	qíngsè	erotic
想上你	xiǎng shàng nǐ	(I) want to mount you
懆您妈	cǎo nín mā	fuck your mother
懆您娘	cǎo nín niáng	fuck your mother
懒8	lǎnbā	bollocks
懒八	lǎnbā	bollocks
懒叫	lǎnjiào	too lazy to be taught (?)
懒教	lǎnjiāo	too lazy to be taught (?)
戇卵	zhuàng luǎn	stupid dick
戇鳩	zhuàng jiū	stupid turtledove
成人	chéngrén	adult
我去	wǒqù	dang!
我操	wǒ cāo	fuck! [I fuck]
我操你祖宗十八代	wǒ cāo nǐ zǔzōng shíbā dài	I'll fuck eighteen generations of your ancestors
我肏	wǒ cào	fuck! [I fuck]
戳㑚	chuō nuó	fuck! [Wu]
扒光	bāguāng	stripped
打	dǎ	to hit (= to fuck)
打潛艇	dǎ qiántǐng	to masturbate [female] (?) ["to play a submarine"]
打炮	dǎpào	to have sex
打飞机	dǎ fēijī	to masturbate [male] ["to play an airplane"]
抽插	chōu chā	to slide in and out
拍手銃	pāishǒu chòng	to jerk off [Min Nan]
招妓	zhāo jì	to recruit a prostitute
插你	chā nǐ	(I'll) fuck you!
插死你	chā sǐ nǐ	(I'll) fuck you dead
撒尿	sāniào	to piss	
撕屄	sībī	to have a bitch fight
撕逼	sībī	to have a bitch fight
撚	lán	penis [Cantonese]
操	cāo	to fuck
操你	cāo nǐ	(I'll) fuck you
操你全家	cāo nǐ quánjiā	(I'll) fuck your whole family
操你奶奶	cāo nǐ nǎinai	(I'll) fuck your grandmother
操你妈	cào nǐ mā	(I'll) fuck your mother	
操你娘	cāo nǐ niáng	(I'll) fuck your mother
操你媽	cào nǐ mā	(I'll) fuck your mother
操你祖宗	cāo nǐ zǔzōng	(I'll) fuck your ancestors
操你老妈	cāo nǐ lǎomā	(I'll) fuck your old mother
操你老母	cāo nǐ lǎomǔ	(I'll) fuck your old mother	
操妳	cào nǐ	fuck you!
操妳全家	cāo nǎi quánjiā	(I'll) fuck your family
操妳妈	cāo nǐ mā	(I'll) fuck our mother
操妳娘	cāo nǐ niáng	(I'll) fuck your mother
操妳祖宗	cāo nǐ zǔzōng	(I'll) fuck your ancestors
操屄	càobī	to fuck (cunt)
操机掰	cāojībāi	to fuck (cunt)
操比	cāobǐ	to fuck (cunt)
操逼	càobī	to fuck (cunt)
放荡	fàngdàng	immoral
日	rì	to fuck ["sun", replacement for taboo character]
日他娘	rì tā niáng	fuck his mother
日你	rì nǐ	fuck you!
日你妈	rì nǐ mā	fuck your mother
日你老娘	rì nǐ lǎoniáng	fuck your old mother
日你老母	rì nǐ lǎomǔ	fuck your old mother
日批	rì pī	to fuck and slap (?)
月经	yuèjīng	menstruation
机八	jībā	cock		
机巴	jībā	cock
机机歪歪	jījī wāiwāi	blabbermouth
杂种	zázhǒng	son of a bitch
柒頭	qītóu	dickhead
柒頭皮	qītóupí	dickhead
榦	gàn	to fuck
死人	sǐrén	dead person
毒撚	dúniǎn	lonely boy [Cantonese]
毴	bī	cunt
洽潲	qiàshào	fool [Min Nan]
淫	yín	kinky
淫乱	yínluàn	slutty
淫妇	yín fù	prostitute
淫棍	yíngùn	dirty old man
淫水	yínshuǐ	sexual secretions
淫秽	yínhuì	obscene	
淫荡	yíndàng	loose in morals
淫西	yín xī	kinky westerner [?]
湿透的内裤	shī tòu de nèikù	drenched underpants
潲	shào	to sprinkle
激情	jīqíng	passion
灨你娘	gàn nín	niáng	fuck your mother
烂货	làn huò	soft junk
烂逼	làn bī	soft cunt	
爆菊	bàojú	to hava anal sex ["to burst the chrysanthemum]
爛	làn	crappy
狗屁	gǒupì	bullshit ["dog shit"]
狗屎垃圾	gǒu shǐ lèsè	bullshit trash
狗日	gǒurì	fucked by a dog
狗狼养的	gǒu láng yǎng de	wolf-bearing
玉杵	yùchǔ	pestle [= penis?]
王八蛋	wángbā dàn	son of a bitch
球	qiú	balls [?]
球兒屁	qiú ér pì	balls fart [?]
瓜娃子	guā wázi	retarded child ["melon baby"]
瓜婆娘	guā póniáng	retarded woman
瓜批	guā pī	stupid cunt [?]
瘪三	biēsān	a wretched-looking tramp who lives by begging or stealing	
白烂	báilàn	idiot [?]
白痴	báichī	idiot
白癡	báichī	idiot
硬膠	yìngjiāo	idiot [Cantonese]
碧池	bìchí	bitch
碧池臉	bìchí liǎn	bitch face
祖宗	zǔzōng	ancestor
私服	sīfú	unlicensed individuals
笨蛋	bèndàn	idiot
箍	gū	to fuck [Hokkien]
精子	jīngzǐ	sperm
老二	lǎoèr	penis
老卵	lǎo luǎn old ovum
老味	lǎo wèi	old taste
老母	lǎo mǔ	old mother	
老瘪三	lǎo biēsān	old wretched-looking tramp
老骚比	lǎo sāobī	old slut
老骚货	lǎo sāohuò	old slut	
聊騷	liáo sāo	flirty chat
肉壁	ròu bì	flesh wall [= ?]
肉棍子	ròu gùnzi	flesh rod [= penis]
肉棒	ròubàng	flesh stick [= penis]
肉缝	ròuféng	flesh needle [= penis]
肏	cào	to fuck
肏你妈	cào nǐ mā	fuck your mother
肏你媽	cào nǐ mā	fuck your mother
肏屄	cào bī	to fuck
肏逼	cào bī	to fuck
肛交	gāngjiāo	anal intercourse
膣	zhì	vagina
臥槽	wò cáo	to have sex
色情	sèqíng	pornographic
花柳	huāliǔ	brothel ["flowers and willows"]
苦屄	kǔ bī	bitter cunt
荡妇	dàngfù	slut
衰潲	cuī shào	to sully the mourning garments
装逼	zhuāngbī	to act like a pretentious prick
裝屄	zhuāngbī	to act like a pretentious prick
裝逼	zhuāngbī	to act like a pretentious prick
豬頭三	zhūtóu sān	three pig heads
賤	jiàn	lowly
賤人	jiànrén	slut
賤貨	jiànhuò	bitch
贝肉	bèiròu	shellfish meat [?; implies flesh for money => prostitute?]
贱b	jiàn bī	cheap cunt
贱人	jiànrén	slut
贱货	jiànhuò	bitch
贼你妈	zéi nǐ mā	(I'll) rape your mom
赛你老母	sài nǐ lǎomǔ	fuck your old mother
赛妳阿母	sài nǐ ā mǔ	fuck your mother
赣您娘	gàn nín	niáng	fuck your mother
赤佬	chì lǎo	naked man
轮奸	lúnjiān	to gang rape
迷药	míyào	knockout drops
逗屄	dòu bī	to tease cunt
逼	bī	cunt
逼样	bīyàng	cunt type
逼格	bīgé	swaggering
過水	guò shuǐ	to have sex [old-fashioned: "to let the water flow"]
野鸡	yějī	prostitute
閪	hāi	pussy [Cantonese]
阳具	yángjù	penis		
阳萎	yángwěi	impotence
阴唇	yīnchún	labia
阴户	yīnhù	vulva
阴核	yīnhé	clitoris
阴毛	yīnmáo	pubic hair
阴茎	yīnjīng	penis
阴道	yīndào	vagina
阴部	yīnbù	genitalia
雞巴	jība	dick
靠北	kàoběi	fuck!
靠母	kào mǔ	fuck mother
靠爸	kào bà	fuck father
靠背	kàobèi	backrest
靠腰	kàoyāo	shut the hell up!
頂你個肺	dǐng nǐ gè fèi	go fuck yourself! [Cantonese]
食蕉	shí jiāo	to eat banana [= to have oral sex]
騎	qí	to ride	
騷屄	sāo bī	flirty cunt
驶你公	shǐ nǐ gōng	to gallop your husband
驶你娘	shǐ nǐ niáng	to gallop your mother
驶你母	Shǐ nǐ mǔ	to gallop your mother
驶你爸	shǐ nǐ bà	to gallop your father
驶你老师	shǐ nǐ lǎoshī	to gallop your teacher
驶你老母	shǐ nǐ lǎomǔ	to gallop your mother
骑	qí	to ride
骚屄	sāo bī	flirty cunt
骚比	sāo bǐ	smell of urine
骚货	sāohuò	slut
骚逼	sāobī	bitch
鬼	guǐ	ghost
鬼公	guǐ gōng	ghost public
鳥	diǎo	penis
鳩	jiū	turtledove
鸟	diǎo	penis	
鸡8	jībā	penis
鸡八	jībā	penis
鸡叭	jībā	penis
鸡吧	jība	penis
鸡奸	jījiān	bestiality
鸡巴	jība	penis
鸡芭	jībā	penis
鸡鸡	jījī	penis
龟儿子	guī érzi	bastard
龟头	guītóu	glans penis
